...............
..##..##..##...
....@@@@@@@@...
....@@@@@@@@...
..##@@@@@@@##..
..###########..
..@@@@@@@@@@@..
..@@@@@@@@@@@..
.#############.
.#..........#..
.#..........#..
..#####@@@###..
...............