##################
#................#
#................#
#...##..##..##...#
#.....@@@@@@@@...#
#.....@@@@@@@@...#
#...##@@@@@@@##..#
#...###########..#
#...@@@@@@@@@@@..#
#...@@@@@@@@@@@..#
#..############..#
#..#..........#..#
#..#..........#..#
#...#####@@@###..#
#................#
#................#
##################