########################################################
#......................................................#
#......................................................#
#......................................................#
#............@@@@@.....................................#
#............@@@@@@@@@@@...............................#
#......................................................#
#......................................................#
#......................................................#
#............@@@@@@@@@@@@@@@@@@@@@@@@@@@@@@@@@.........#
#......................................................#
#......................................................#
#......................................................#
#......................................................#
#......................................................#
#......................................................#
#......................................................#
#......................................................#
#......................................................#
#......................................................#
########################################################